XXXXXXXXXX    
XXsf  soXX    
XX      XX    
XX      XXXXXX
XX      XF  XX
XX      XX  XX
XXPPPPPPXX  XX
XX      XX  XX
XX      XF  XX
XXGG  GGXXXXXX
XXXXXXXXXX    