XXXXXXXXXXXXXXXXXXXX
XX  GG  XXXX  GG  XX
XX      XXXX      XX
XX  ef  XXXX  eo  XX
XX      XXXX      XX
XX      XXXX      XX
XX      XXXX      XX
XX      XXXX      XX
XX      XXXX      XX
XXX2X2X2X2X1X1X1X1XX
XX      XXXX      XX
XX  S1  XXXX  S2  XX
XXEf  EoXXXXEf  EoXX
XX      XXXX      XX
XX      XXXX      XX
XX  sf  XXXX  so  XX
XXXXXXXXXXXXXXXXXXXX