OOOOOOOOOOOOOOOOOOOOOOOOOOOOOOOOOOOOXXOOOOXXOOOOOO
OOOOOOOOOOOOOOOOOOOOOOOOOOOOOOOOOOOOXXBBBBXXOOOOOO
OOOOOOOOOOOOOOOOOOOOOOOOOOOOOOOOOOOOXXOOOOXXOOOOOO
OOOOOOOOOOXXXXXXXXXXXXXXXXXXXXXXXXXXXXOOOOXXXXXXXX
OOOOOOOOOOXXOOsfOOOOOOOOOOOOOOPPPPPPPPOOOOCCOOOOXX
OOOOOOOOOOXXOOOOOOOOOOOOOOOOOOPPPPPPPPOOOOCCOOOOXX
OOOOOOOOOOXXOOsoOOOOOOOOOOOOOOPPPPPPPPOOOOCCOOOOXX
OOOOOOOOOOXXXXXXXXXXXXXXXXXFXFXXXXXXXXXXXXXXOOOOXX
OOOOOOOOOOOOOOOOOOOOOOOOXXOOOOOOOOOOOOOOOOOOOOOOXX
OOOOOOOOOOOOOOOOOOOOOOOOXXOOOOOOOOOOOOOOOOOOOOOOXX
OOOOOOOOOOOOOOOOOOOOOOOOXXXXXXXXXXXXXXXXXXXXXXXXXX