XXXXXXXXXXXXXXXXXXXXXXXXXXXXXXXXXXXXXXXX
XX  sf              X1      BB      GGXX
XX            S1    X1      BB        XX
XX  so              X1      BB      GGXX
XXXXXXXXXXXXXXXXXXXXXXXXXXXXXXXXXXXXXXXX