OOOOOOOOOOOOOOOOOOXXXXXXXXXXXXX1X1X1XXXXXXXXXXXXOOOOOOOOOOOOOOOOOO
OOOOOOOOOOOOOOOOOOXXOOOOOOOOOOOOOOOOOOOOOOOOOOXXOOOOOOOOOOOOOOOOOO
OOOOOOOOOOOOOOOOOOXXOOOOOOOOOOOOOOOOOOOOOOOOOOXXOOOOOOOOOOOOOOOOOO
OOOOOOOOOOOOOOOOOOXXOOOOOOOOOOOOOOOOOOOOOOOOOOXXOOOOOOOOOOOOOOOOOO
OOOOOOOOOOXXXXXXXXXXOOOOOOOOOOOOOOOOOOOOOOOOOOXXXXXXXXXXOOOOOOOOOO
OOOOOOOOOOXXOOOOOOX1OOOOOOOOOOOOOOOOOOOOOOOOOOX1OOOOOOXXOOOOOOOOOO
OOOOOOOOOOXXOOOOOOX1OOOOOOOOOOOOS1OOOOOOOOOOOOX1OOOOOOXXOOOOOOOOOO
OOOOOOOOOOXXOOOOOOX1OOOOOOOOOOOOOOOOOOOOOOOOOOX1OOOOOOXXOOOOOOOOOO
OOOOOOOOOOXXXXXXXXXXOOOOOOOOOOOOOOOOOOOOOOOOOOXXXXXXXXXXOOOOOOOOOO
OOOOOOOOOOOOOOOOOOXXOOOOOOXXXXXXXXXXXXXXOOOOOOXXOOOOOOOOOOOOOOOOOO
OOOOOOOOOOOOOOOOOOXXOOOOOOOOOOOOOOOOOOOOOOOOOOXXOOOOOOOOOOOOOOOOOO
OOOOOOOOOOOOOOOOOOXXOOOOOOOOOOOOOOOOOOOOOOOOOOXXOOOOOOOOOOOOOOOOOO
OOOOOOOOOOOOOOOOOOXXXXXXXXXXXXOOOOOOXXXXXXXXXXXXOOOOOOOOOOOOOOOOOO
OOOOOOOOOOOOOOOOOOOOOOOOOOOOXXOOOOOOXXOOOOOOOOOOOOOOOOOOOOOOOOOOOO
OOOOOOOOOOOOOOOOOOOOOOOOOOOOXXOOOOOOXXOOOOOOOOOOOOOOOOOOOOOOOOOOOO
OOOOOOOOOOOOOOOOOOOOOOOOOOOOXXOOOOOOXXOOOOOOOOOOOOOOOOOOOOOOOOOOOO
OOOOOOOOOOOOOOOOOOOOOOOOOOOOXXOOOOOOXXOOOOOOOOOOOOOOOOOOOOOOOOOOOO
OOOOOOOOOOOOOOOOOOOOOOOOOOOOXXsfOOsoXXOOOOOOOOOOOOOOOOOOOOOOOOOOOO
OOOOOOOOOOOOOOOOOOOOOOOOOOOOXXXXXXXXXXOOOOOOOOOOOOOOOOOOOOOOOOOOOO