XXXXXXXXXXXX
XXGGGGXX^^XX
XX  BBXXXOXX
XXsfsoXXXFXX
XXXXXXXXt1XX
XXefeoXXt4XX
XXXXXXXXXXXX