XXXXXXXXXXXXXXXXXXXX
XXCCBBGGPPPP^^OOOOXX
XXOOOOOOeoPPefOOPPXX
XXOOOOOOOOPPOOOOOOXX
XXOOOOOOX1X2OOOOOOXX
XXOOOOOOP2P1OOOOOOXX
XXsfXFS2OOOOS1XOsoXX
XXXXXXXXXXXXXXXXXXXX