XXXXXXXXXXXX
XXGGGGXX^^XX
XX    XXXOXX
XXsfsoXXXFXX
XXXXXXXXt1XX
XXefeoXXt1XX
XXXXXXXXXXXX