XXXXXXXX
XXGGGGXX
XX    XX
XX    XX
XX    XX
XX    XX
XX    XX
XXsfsoXX
XXXXXXXX